kya	きゃ	キャ
kyu	きゅ	キュ
kyo	きょ	キョ
sha	しゃ	シャ
sya	しゃ	シャ
shu	しゅ	シュ
syu	しゅ	シュ
sho	しょ	ショ
syo	しょ	ショ
cha	ちゃ	チャ
tya	ちゃ	チャ
chu	ちゅ	チュ
tyu	ちゅ	チュ
cho	ちょ	チョ
tyo	ちょ	チョ
nya	にゃ	ニャ
nyu	にゅ	ニュ
nyo	にょ	ニョ
hya	ひゃ	ヒャ
hyu	ひゅ	ヒュ
hyo	ひょ	ヒョ
mya	みゃ	ミャ
myu	みゅ	ミュ
myo	みょ	ミョ
rya	りゃ	リャ
ryu	りゅ	リュ
ryo	りょ	リョ
gya	ぎゃ	ギャ
gyu	ぎゅ	ギュ
gyo	ぎょ	ギョ
ja	じゃ	ジャ
zya	じゃ	ジャ
ju	じゅ	ジュ
zyu	じゅ	ジュ
jo	じょ	ジョ
zyo	じょ	ジョ
bya	びゃ	ビャ
byu	びゅ	ビュ
byo	びょ	ビョ
pya	ぴゃ	ピャ
pyu	ぴゅ	ピュ
pyo	ぴょ	ピョ
va		ヴァ
vi		ヴィ
vu		ヴ
ve		ヴェ
vo		ヴォ
tsa		ツァ
tsi		ツィ
tse		ツェ
tso		ツォ
fa		ファ
fi		フィ
fe		フェ
fo		フォ
ye		イェ
she		シェ
je		ジェ
che		チェ
whi		ウィ
whe		ウェ
who		ウォ
thi		ティ
thu		テュ
twu		トゥ
dhi		ディ
dhu		デュ
dwu		ドゥ
ka	か	カ
ki	き	キ
ku	く	ク
ke	け	ケ
ko	こ	コ
sa	さ	サ
shi	し	シ
si	し	スィ
su	す	ス
se	せ	セ
so	そ	ソ
ta	た	タ
chi	ち	チ
ti	ち	チ
tsu	つ	ツ
tu	つ	ツ
te	て	テ
to	と	ト
na	な	ナ
ni	に	ニ
nu	ぬ	ヌ
ne	ね	ネ
no	の	ノ
ha	は	ハ
hi	ひ	ヒ
fu	ふ	フ
hu	ふ	フ
he	へ	ヘ
ho	ほ	ホ
ma	ま	マ
mi	み	ミ
mu	む	ム
me	め	メ
mo	も	モ
ya	や	ヤ
yu	ゆ	ユ
yo	よ	ヨ
ra	ら	ラ
ri	り	リ
ru	る	ル
re	れ	レ
ro	ろ	ロ
wa	わ	ワ
wo	を	ヲ
ga	が	ガ
gi	ぎ	ギ
gu	ぐ	グ
ge	げ	ゲ
go	ご	ゴ
za	ざ	ザ
ji	じ	ジ
zi	じ	ズィ
zu	ず	ズ
ze	ぜ	ゼ
zo	ぞ	ゾ
da	だ	ダ
di	ぢ	ディ
du	づ	ドゥ
de	で	デ
do	ど	ド
ba	ば	バ
bi	び	ビ
bu	ぶ	ブ
be	べ	ベ
bo	ぼ	ボ
pa	ぱ	パ
pi	ぴ	ピ
pu	ぷ	プ
pe	ぺ	ペ
po	ぽ	ポ
a	あ	ア
i	い	イ
u	う	ウ
e	え	エ
o	お	オ
xa	ぁ	ァ
xi	ぃ	ィ
xu	ぅ	ゥ
xe	ぇ	ェ
xo	ぉ	ォ
xya	ゃ	ャ
xyu	ゅ	ュ
xyo	ょ	ョ
xtu	っ	ッ
xtsu	っ	ッ
xwa	ゎ	ヮ
xn	ん	ン
n'	ん	ン
n	ん	ン
-	ー	ー
